00000000000000000
00002111111120000
00211333333311200
00233333333333200
02133333333333120
02333333333333320
02333333333333320
02333333333333320
02333333333333320
02333333333333320
02333333333333320
02333333333333320
01233333333333210
00233333333333200
00112333333321100
00001111111110000
00000000000000000