00000000000000000
00000111111100000
00011333333311000
00233333333333200
00133333333333100
02333333333333320
02333333333333320
02333333333333320
02333333333333320
02333333333333320
02333333333333320
01333333333333310
00233333333333200
00133333333333100
00011333333311000
00000111111100000
00000000000000000